NO ./img/sboo.xpm
SO ./img/sboo.xpm
WE ./img/sboo.xpm
EA ./img/sboo.xpm

F 220,100,0
C 225,30,0

111111111111
100000000001
101111111101
101111111101
101111111101
1000000N0001
111111111111
