NO ./img/sboo.xpm
SO ./img/sboo.xpm
WE ./img/sboo.xpm
EA ./img/sboo.xpm

F 220,100,0
C 225,30,0

111111111111111111111
10000000000000000111
1000100111011111111111111
11110001111111101 011
11000011111N1111111
11111111111111111111
