NO ./img/sboo.xpm
SO ./img/sboo.xpm
WE ./img/sboo.xpm
EA ./img/sboo.xpm

F 220,100,0
C 225,30,0

111111111111111111111
10000000000000000111
1000101111011111111111111
1110011 1111110011
11000011 11111111111
11111111111111111111
