NO ./img/sboo.xpm
SO ./img/sboo.xpm
WE ./img/sboo.xpm
EA ./img/sboo.xpm

F 220,100,0
C 225,30,0

1111111111111111
1000000000000001
1000111111110001
10001N0000110001
1000111111110001
1000000000000001
1111111111111111
