NO ./img/sboo.xpm
SO ./img/sboo.xpm
WE ./img/sboo.xpm
EA ./img/sboo.xpm

F 220,100,0
C 225,30,0

                         11 
                         11     
     1                    1    11
  111111111111111111111111111111
 10000000000000000000000011111
 111000N100111011101111111101
   11100011 1111000011    101
   1100001 1 111100111    110011
111111111 11111111111111111111 111011
   1                       11
