NO ./img/sboo.xpm
SO ./img/sboo.xpm
WE ./img/sboo.xpm
EA ./img/sboo.xpm

F 220,100,0
C 225,30,0                                                   
																				           111111111111111111
11111111111111111111111111111111111111111111111111111111111111111                         11111001111110000001111
1N0000000111110000000000111111111110000111110000000000111110000011                            111001  1100111
110111111111100111111111100000000001110100001111111111110001110001                              111111111011
100000000000000000011000111111011111000110000000000000000011000001                                    1110111
1001111111111111001111111000000110001111111111111111111111111100011111111111111111111111111111111111111110111
1001000000000111001000001111111111100000000000111111111100000000001000000000000000000000000000000000000000011
1001011111100111111001111000000000001111110000000000011111111110000001111110111111110111110100111111101111111
10010100001000000110010011111110011111111111111111111000100000000111111111111      111   1111111   11011
100101011110111111111100100000000000000000000000000011111110111111111                             1110011     
100101010000000001000000000000000000000111111111111110000000100001                                  11111  
 100101011111111101011111100000000000011000000000000011111110101111
100101000000000101010000111111000000011110111100000000000010101001
100111111111110101011111100000001000000000011111111111111110101001
100000000000000101010000011111111111111110000000000000000000101001
111111111111111101011111100000000000000011111111111111111111101111
100000000000000001010000011111111111111110000000000000000000001001
111111111111111111011111100000000000000011111111111111111111111001
100010010001000000010000011111111111111110000000000000000000000001
111111111111111111111111111111111111111111111111111111111111111111
