NO ./img/sboo.xpm

WE ./img/sboo.xpm
EA ./img/sboo.xpm

C 225,30,0

                                   111111111
                                   100110011
                                    1000011
     11111111111111111111111111111111000111
    10000000000000000000000000000000000011
    1011111111111111110110111111111111100011111
11111011111111111   110110111          110111     
110000011          11100001111         11000111
110110011111         110101111         11000111
1000N00000001111111111110011111111111111110111
10011011111000000000000000000000000000000001       11111111111
1100001   1011111111111111111011111111111101111111111100000001
11010111111011             110011      11100000000000000011111
1100000000001              110011111  110001111111111111011
111111111111             1111001111111000111           111
                        11000000000000011
                        1110000001111111
                          1110000111111111111111
                           11111000000000000000011
                               1100000010000101111
                                1101000000001011
                                11111000010111
                                    11010001
                                111111111111111
