NO ./img/sboo.xpm
SO ./img/sboo.xpm
WE ./img/sboo.xpm
EA ./img/sboo.xpm

F 220,100,0
C 225,30,0

1111111111111
10000000110011
1011111111111
1011111N01 1
1011111111    
10000001   
111111111111
