NO ./img/sboo.xpm
SO ./img/sboo.xpm
WE ./img/sboo.xpm
EA ./img/sboo.xpm

F 220,100,0
C 225,30,0

1111111111111111
1N00000000000001
1110111111011111
1000110000010001
1011111111111101
1000000000000001
1111110111111111
1000000100000001
1111111111111111
