NO ./img/sboo.xpm
SO ./img/sboo.xpm
WE ./img/sboo.xpm
EA ./img/sboo.xpm

F 220,100,0
C 225,30,0

        
		1111111
		1111111
		1111111
1111111111111111
1N00110011001101
1000000100000001
1100111111110011
100000000000001
1111011001101111
1000000000000001
1111111111111111
