NO ./img/sboo.xpm
SO ./img/sboo.xpm
WE ./img/sboo.xpm
EA ./img/sboo.xpm

F 220,100,0
C 225,30,0

1111111111111111
1N00011110000001
1110001111000111
1000000000000001
1111000111111001
1000000000000001
1111111111111111
